# File with door texture and door on the map

NO textures/brick1.xpm
SO textures/brick1.xpm
WE textures/brick1.xpm
EA textures/brick1.xpm
DO textures/brick1.xpm

F 220,100,0
C 225,30,0

1111
1ND1
1111
