# File with all the information together
NO textures/brick1.xpm
SO textures/brick1.xpm
WE textures/brick1.xpm
EA textures/brick1.xpm
F 220,100,0
C 225,30,0
        1111111111111111111111111
        1001000000000000000000001
1111111110110000011100000000E0001
111111111111111111111111111111111