NO textures/brick1.xpm
SO textures/brick1.xpm
WE textures/brick1.xpm
EA textures/brick1.xpm
DO textures/brick1.xpm
F 220,100,0
C 225,30,0

                           1111111111111111111111111
                           1000000000110000000000001
                           1011000001110000000000001
                           1001000000000000000000001                          11111
        111        111111111011000001110000000000001                 1111111111000111111111             
   11111001        100000000011000001110111111111111              1111000000000000000000111        
   100000011       11110111111111011100000010001                    110000000000000000011          
    1111111        11110111111111011101010010001                     1000000000000000001           
                   11000000110101011100000010001                     1000000000000000001
                   10000000000000001100000010001                     10000000000000000011111111
                   10000000000000001101010010001                     10000000000000000000000111   
                   11000001110101011111011110N0111                   1111100000000001111111111
                   11110111 1110101 101111010001                         11111111111
                   11111111 1111111 111111111111
