# Map with many rooms

NO textures/brick1.xpm
SO textures/brick1.xpm
WE textures/brick1.xpm
EA textures/brick1.xpm
DO textures/brick1.xpm
F 220,100,0
C 225,30,0

        11111
      111000111
    1110011100111
    11111   11111
 
         111
         101
         1S1
         101
         111
