
NO ./textures/tile000.xpm
SO ./textures/tile000.xpm
WE ./textures/tile000.xpm
EA ./textures/tile000.xpm

DO ./textures/tile000.xpm

F 220,100,0

C 225,30,0

111111       
1000N1
100001
101001
111111
