
NO ./textures/tile000.xpm
SO ./textures/tile000.xpm
WE ./textures/tile000.xpm
EA ./textures/tile000.xpm

DO ./textures/tile000.xpm

F 220,100,0

C 225,30,0

11111
1N001
10001
10101
11111
