# Views textures
NO ./textures/tile000.xpm
SO ./textures/tile000.xpm
WE ./textures/tile000.xpm
EA ./textures/tile000.xpm

; The next line can be commented
DO ./textures/tile000.xpm

# Floor color (RGB)
F 220,100,0

# Ceiling color (RGB)
C 225,30,0

# Mapa
111111111111111111111111
100000000000000000000001
100000000000000000000001
100000000000000000000001
100000000000000000000001
100000000000000000000001
100000000000000000000001
100000000000000000000001
100000000000000000000001
100000000000000000000001
100000000000000000000001
100000000000000000000001
100000000000000000000001
100000000000000000000001
100000000000000000000001
100000000000000000000001
100000000000000000000001
100000000000000000000001
100000000000000000000001
100000000000000000000001
100000000000000000000001
100000000000000000000001
100000000000000000000001
111111111111111111111111