# Views textures
NO ./textures/tile000.xpm
SO ./textures/tile000.xpm
WE ./textures/tile000.xpm
EA ./textures/tile000.xpm

; The next line can be commented
DO ./textures/tile000.xpm

# Floor color (RGB)
F 171,96,89

# Ceiling color (RGB)
C 100,252,252

# Mapa

111111111111111111111111
1D0000000000000000000001
100000000000000000000001
100000000000000000000001
100000111110000101010001
100000100010000000000001
100000100010000100010001
100000100010000000000001
100000110110000101D10001
100000000000000000000001
100000000000000000000001
100000000000000000000001
10000000000000000N000001
100000000000000000000001
100000000000000000000001
100000000000000000000001
111111111000000000000001
110100001000000000000001
110000101000000000000001
110100001000000000000001
110111111000000000000001
110000000000000000000001
111111111000000000000001
111111111111111111111111